16 26
3 3
38
-
WWWWWWWWWWWWWWWWWWWWWWWWWW
WDGSDDDDDRDDDDDDDDDDDDDDDW
WDDDEpEEDEDEDRRDDEEDEDDRDW
WDDPEEEEDSREEEER****EEEE*W
WWWWWWWWWWW**EEDEEEEEEDD*W
WEEEEEEEEEEEEEESEEEEEEEEEW
W**EEEEDDDEEEEEEEEEEEEEEEW
W*****DDDDDERRWW*********W
WEEEEEEEEEEEEEEEEEEEEEEEEW
WDDDDDRDRDWWWWWWWWWWWWWWWW
WDDDRR*****EE**EEEEEEEEEEW
WEEEEEEEEEEEE**EEEEEEEEEEW
WWWWWWWWWEEEEEEEEDEEEEEE*W
WEDEEDDERDDDDDDDDDEDEEEE*W
WEEEEEEEEEEEEEEDEEED***EDW
WWWWWWWWWWWWWWWWWWWWWWWWWW