16 26
3 3
38
-
WWWWWWWWWWWWWWWWWWWWWWWWWW
WDDDDDDDDDDDDDDDDDDDDDDDDW
WDDDEEEEDLDEDRRDDEEDEDDRDW
WDDPEEEEERREEEERXXXXEEEEXW
WWWWWWWWWWWXXEEDEEEEEEDDXW
WEEEEEEEEEEEEEESEEEEEEEEEW
WXXEEEEDDDEEEEEEEEEEEEEEEW
WXXXXXDDDDDERRWWXXXXXXXXXW
WEEEEEEEEEEEEEEEEEEEEEEEEW
WDDDDDRDRDWWWWWWWWWWWWWWWW
WDDDRRXXXXXEEXXEEEEEEEEEEW
WEEEEEEEEEEEEXXEEEEEEEEEEW
WWWWWWWWWEEEEEEEEDEEEEEEXW
WEDEEDDERDDDDDDDDDEDEEEEXW
WEEEEEEEEEEEEEEDEEEDXXXEDW
WWWWWWWWWWWWWWWWWWWWWWWWWW