Boulder Pit
12 20
10 18
36
100 1400
-
WWWWWWWWWWWWWWWWWWWW
WZDDDDDDDDDDDDDDDDDW
W******************W
WRRRRRRRRRRRRRRRRRRW
WDDDDDDDDDDDDDDDDDDW
WDDDDDDDDDDDDDDDDDDW
W******************W
WRRRRRRRRRRRRRRRRRRW
WDDDDDDDDDDDDDDDDDDW
WDDDDDDDDDDDDDDDDDDW
WDDDDDDDDDDDDDDDDDPW
WWWWWWWWWWWWWWWWWWWW