Water Maze
22 40
9 20
6
30 1400
-
WWWWWWWWWWWWWWWWWWWWWWWWWWWWWWWWWWWWWWWW
WWWWWWWWWWWWWWWWWWWWWWWWWWWWWWWWWWWWWWWW
WWGWDDDWDDDWDDDDDDDDWDDDWDDDDDWWDDWDDGWW
WWDDDDDDDWDDDDDDWDDDWDDDDDDWWDDDWDDWWDWW
WWWWDDWDWDWDDDDDDDDWDDDWWDDDDWDWWDDDDDWW
WWWDDDDWDDDDDDDDDWDWWDWDDDWWDDWDDWDDWDWW
WWDDWDWDDWWDDDDDWDDWDDWDDDDDWDDDDDWDDWWW
WWDWDDDDWDDDDDDDDWDWDWWDDDDDWDDDDWDWDWWW
WWDWDDDWDDWDDDDDWWWDDDDWDDDWDDDDDWWDDDWW
WWDDWWDDWDDDDDDDDWDWPDDWDDDDDDDDDWDDWDWW
WWWDDDWDDWDDDGDDDDDDWWWWWWWWDDWWWDDWDDWW
WWWDDWDDWDDDDDDDDWDDDDDDDDDDWDDDDWWDWDWW
WWWDWDDWDDDDDDDDDDWWDDDWDDWDWDDDDWDDDDWW
WWDDDDDDDDDDDDDDWDDDWDDDDDDDDWDWWWDWDDWW
WWWDDDDDDWDDDDDDDDDWDDDDWWWWDWDWDDDDWEEW
WWWDDDDDDWDDDDDDDDDWDDDDDDDDWWDWDDDDZWWW
WWDWDDDDDDDDDDDDWDWDWDDDDWWDDDDWDDDDWWWW
WWDDWDDDDWDDDDWDDDDDWDDDWWDDDWWWDDW***WW
WWWDDDWDWDDWDWDDDDWWWDDDDWDDDDDDDDW***WW
WWDGWDDWWDWWDDWDWDDDDDWWDDDDDDWDDDEEEEWW
WWWWWWWWWWWWWWWWWWWWWWWWWWWWWWWWWWWWWWWW
WWWWWWWWWWWWWWWWWWWWWWWWWWWWWWWWWWWWWWWW