Adventurer
22 40
10 1
21
150 1400
-
WWWWWWWWWWWWWWWWWWWWWWWWWWWWWWWWWWWWWWWW
WDD*DDDRDR*RDDDDDDDDDDEDDRDEDDDDDDDRDDRW
WRDDDDRDDDEDEDDDDDDRERDDDDRDDDEDDDEDDDDW
WDRDDERDD*DRDEDDDRDDDEDRDDDDEDDRDEDDE*RW
WDEDDDEDDRDEEDDDDDEDDDDRDDDD*DDDDDDDDDDW
WDDDRDDDDRREDRDDDEDE*DDEDDDR*DDRDDRDDDEW
WDRDDDDEDDDDDREDDRDDDDDDEEDDDDEDDRDDERDW
WDDDWWWWWWWWWWWWWWWWWWWWWWWWWWWWWWWDDDRW
WDDDDEDRDDDDEDDDDRDDEDDEDDRDDDDEDDDDDDDW
WDDDDDDDDDRDDDDDDDDDDDDRDDD*RRDD*DRDRDDW
WP*DRDDDDERDRRD*DDDDDRDDRDDDDDDRDRDD*RZW
WDDRREDDDDRDRRDDRDDRDDDDDDDDDEDDRDDDDDDW
WDDDDD*DDDDDDDDDEDDDDDEDD*DDDRDDDDDRDDDW
W*DDDDRDRDDRDDDDDDDRDDDDEDDDEERDDDDEDDDW
WDEDWWWWWWWWWWWWWWWWWWWWWWWWWWWWWWWDRDRW
WDDDDEDEDDDRDDDRDDDDEDDEDRDDDDDDDDDEDDRW
WDDDDDDDREDDDDDDDRDDDDDDDEDDRDDDREDDDRRW
WED*DDDREDDDDDRDERRDDDDD*DDDDDDDDDDDDDDW
WRDDDEDDEDDEDDDRDDDDRDRDDDRDDRDRDDDDDDRW
WRDDRDEDDD**DEDDDDDDDDEDDDRDDDDDRDDDE*EW
WDDRRDD*RDDDDDDDDDRDDDRRDDDDEDDDREDDDDRW
WWWWWWWWWWWWWWWWWWWWWWWWWWWWWWWWWWWWWWWW