Spiders den
22 40
1 2
4
130 1400
-
WWWWWWWWWWWWWWWWWWWWWWWWWWWWWWWWWWWWWWWW
WEPDEDDDDDDERRDRDDDDDDREDDRDDEDDRRDDRDDW
WDDDDDRRDDDDDDEERDRDEDRDDDRDDDDDDRDDDDDW
WDDDRDDDDDDDMDDREDDDDDREDDDDRDRDRDDDEDEW
WDDDDDDRDDDDDDDDDDDDDDDRDDRDDDDRDDDMDDDW
WRRDDDDDDDDDRRERRRDDDDDEDDRRDDDDRDDDDDDW
WDDDDRDDREDDRDRDDDRRDDDDRDDDDDDDDDDREDDW
WDEDDDDRDDDRDRRRDRDDDDDDDEDDDDDDDDEDRDDW
WDDDDEDDDDRRDDDRDRDDDDRDDRDDRDDDRDDDDRDW
WDDDDRDDDDEDDDDDDDDDRDDDDDDDDDDDDDDRRDRW
WDDDDDEDMDDDDDDDDDDDDDDDDEEEEEEDDDDDEDDW
WDDDDEDDDDDDDDDDDDDRDDERDEEEEEEDDDRDDDDW
WDDDDDDDDDDDDDDDDDDEDDDDEEEEEEEDRDDDDDDW
WDRRDDDDDDRDDDDDRDDDDDDDDEESEEEDDDDRDDDW
WDRDDDDRRDEDDDRDDDRRDDDRDDDDDDDDEDDDDDDW
WDDDDEDDDDDDDDERDDDEDRRDDDDDDDDDRRDDDDRW
WDDDRDRDDDDDEDDDDDDDDDDDDDRDDDDRDDDDDDDW
WDDDDDDDDDDDDDWWWWWWWWWWWWWWWWWWWWWWWWWW
WDDDDDDDDDRDDRRDDDDDDRDDDDERDDDDDDRDDDDW
WDDRDDDDDRDDDRDDGDDRDDDDDDDDDDRDRDDDRDEW
WDDDDDDDERDDDWDDDDDDDDDDDDDDDDDDDRRDDDDW
WWWWWWWWWWWWWWWWWWWWWWWWWWWWWWWWWWWWWWWW