Water Maze
22 40
9 20
6
30 1400
-
WWWWWWWWWWWWWWWWWWWWWWWWWWWWWWWWWWWWWWWW
WWWWWWWWWWWWWWWWWWWWWWWWWWWWWWWWWWWWWWWW
WWGWDDDWDDDWDDDDDDDDWDDDWDDDDDWDDDWDDGWW
WWDDDDDDDWDDDDDDWDDDWDDDDDDWWDDDWDDWWDWW
WWWWDDWDWDWDDDDDDDDWDDDWDDDDDWDWWDDDDDWW
WWWDDDDWDDDDDDDDDWDWWDWDDDWWDDWDDWDDWDWW
WWDDWDWDDWWDDDDDWDDDDDDDDDDDWDDDDDWDDWWW
WWDWDDDDWDDDDDDDDWDWDWWDDDDDWDDDDWDWDWWW
WWDWDDDWDDWDDDDDWWDDDDDWDDDWDDDDDWWDDDWW
WWDDWWDDWDDDDDDDDWDWPDDDDDDDDDDDDWDDWDWW
WWWDDDWDDWDDDDDDDDDDWDDDDDWWDDDDDDDWDDWW
WWWDDWDDWDDDDDDDDWDDDDDDDDDDWDDDDWWDWDWW
WWWDWDDWDDDDDDDDDDWWDDDWDDWDWDDDDWDDDDWW
WWDDDDDDDDDDDDDDWDDDWDDDDDDDDDDDDWDWDDWW
WWWDDDDDDWDDDDDDDDDWDDDDDDDDDDDDDDDDWEEW
WWWDDDDDDWDDDDDDDDDWDDDWDDDDDDDDDDDDZWWW
WWDWDDDDDDDDDDDDWDWDWDDDDWWDDDDDDDDDWWWW
WWDDWDDDDWDDDDWDDDDDWDDDWWDDDDDDDDW***WW
WWWDDDWDWDDWDWDDDDWWWDDDDWDDDDDDDDW***WW
WWDGWDDWWDWWDDWDWDDDDDDWDDDDDDWDDDEEEEWW
WWWWWWWWWWWWWWWWWWWWWWWWWWWWWWWWWWWWWWWW
WWWWWWWWWWWWWWWWWWWWWWWWWWWWWWWWWWWWWWWW