22 40
3 4
28
-
WWWWWWWWWWWWWWWWWWWWWWWWWWWWWWWWWWWWWWWW
WDDDRDD*RDDDDDRRRDEDRDDRDDDRDDDDDRRDDDDW
WDRDRDD*DDDDDDDDDDDDDDDDDDRDDDDDRDDDDDRW
WRDEPDD*RDMDRDDDDDDRDDEEDDDDDEDRDRDDDRRW
WRDDDDD*DRDDDDDDDRRRDDDEDDDDRDREDDDRDDDW
WDDREDD*DDRDDDDRRDEDRRDRDDDDREDDRRRDRERW
WDDDRDR*DDERRDDRDDRRDDRDDEDRDERDRRRDDDDW
WDDRRDD*DDRRRR*DDDDDDDRDDDDDDRERDRDDDDDW
WDDDDDD*DRDERD*DRRDDDDDDDDRDDDDERDDRDDDW
WRDDRDE*DRMDDD*DDDDDDDDDDDRDDDRDRDDDDDRW
WDDDEDD*DDDRRR*DDRDDDRRDRDDRDDDDDDRDDRDW
WDERDDD*DRRRRD*DRDDDDRDDDDDRDDDDDERDRDDW
WDDRRDD*DDRRRD*ERDDDDDDDDDDRDDDDDDDDRDDW
WDDDDRD*DRDDRD*RDRRDDDDRRDDDDERDDDREDDDW
WDDDDRD*DRDDDD*RDDDRRDRDDDDRDDDRRRDRDRDW
WRDDDDDMDDDEDD*DRDREDDDDDDDDDDDDDDDDDDDW
WRRDEDEDRRDDDD*DDDDDDRDRRDDDDDDDDRDRDDDW
WDRDERDDDRRDDD*RDDDDDDDRDDDRDDDDDRDRDDRW
WDEDDDEDDDDRDD*DDRDDDDRDDEDRDDDDDDDDDDDW
WDDDDEDRDDRDDD*DEEDDDRDDDRRDRDDEDDDDDDDW
WDDDDDDDDRDDRD*RRDDDDDDDDRDRDDDRRDRDDDDW
WWWWWWWWWWWWWWWWWWWWWWWWWWWWWWWWWWWWWWWW