5 6
-
WWWWWW
WDRDDW
WDDPDW
WDDDDW
WWWWWW