8 8
-
WWWWWWWW
WPDDBBDW
WEEEEEEW
WDDDDDEW
WEEEDEEW
WWWDEEWW
WDEWDDWW
WWWWWWWW