7 6
3 3
-
WWWWWW
WDDDDW
WRRDRW
WEEPEW
WEEEEW
WEEEEW
WWWWWW