7 6
3 3
4
-
WWWWWW
WDDD*W
WRRDRW
WEEPEW
WEEEEW
W***EW
WWWWWW