7 6
3 3
4
-
WWWWWW
WDRD*W
WDDDRW
WEEPEW
WEEEEW
W***EW
WWWWWW