7 6
3 3
4
-
WWWWWW
WDDDXW
WRRDRW
WEEPEW
WEEEEW
WXXXEW
WWWWWW