9 8
3 4
-
WWWWWWWW
WRRRDDDW
WERREERW
WREEPEDW
WEEEEEEW
WEEEEEEW
WWWWEDDW
WDDDDDDW
WWWWWWWW