9 8
3 4
0
-
WWWWWWWW
WRERDDDW
WERDRERW
WREEPEDW
WEEEEEEW
WEEEEEEW
WWWWEDDW
WDDDDDDW
WWWWWWWW