Boulder Pit
18 40
10 18
106
30 1400
-
WWWWWWWWWWWWWWWWWWWWWWWWWWWWWWWWWWWWWWWW
WDDDDDDDDDDDDDDDDDDDDDDDDDDDDDDDDDDDDDDW
W******************WW******************W
WRRRRRRRRRRRRRRRRRRWWRRRRRRRRRRDRRRRRRRW
WDDDDDDDDDDDDDDDDDDWWDDDDDDDDDDDDDDDDDDW
WDDDDDDDDDDDDDDDDDDWWDDDDDDDDDDDDDDDDDDW
W******************WW******************W
WRRRRRRRRRRRRRRRRRRWWRRRRRRRRRRDRRRRRRRW
WDDDDDDDDDDDDDDDDDDWWDDDDDDDDDDDDDDDDDDW
WDDDDDDDDDDDDDDDDDDWWDDDDDDDDDDDDDDDDDDW
WDDDDDDDDDDDDDDDDDPWWDDDDDDDDDDDDDDDDDDW
WWWWWWWWWWWWWWWWWWWWWWWWWWWWWWWWWWWWWWDW
WZ*****************WW*****************DW
WRRRRRRRRRRRRRRRRRDWWDRRRRRRRRRRRRRRRRRW
WDDDDDDDDDDDDDDDDDDWWDDDDDDDDDDDDDDDDDDW
WDDDDDDDDDDDDDDDDDDWWDDDDDDDDDDDDDDDDDDW
WDDDDDDDDDDDDDDDDDDDDDDDDDDDDDDDDDDDDDDW
WWWWWWWWWWWWWWWWWWWWWWWWWWWWWWWWWWWWWWWW