Monster Lair
22 40
10 38
10
150 1400
-
WWWWWWWWWWWWWWWWWWWWWWWWWWWWWWWWWWWWWWWW
WDDDDDDDWD*DDDDDDDDRDRDDDRDWDDDDDDDDDDDW
WDRRRRRDWDDDDDDDDDDDDDDD*DDWDDDDDDD*DDDW
WDRRRRRDWDDDDDDDDDDDWEDWDDDWDDDDRDDDDDWW
WDDDDDDDWWDDDDD*DDDWEEWDDDDWD*DDDDDDDWDW
WDMMMMMDWDWDRDDDDDWEEWDDDDDWDDDDDDDDWDDW
WDEEEEEDWRDWDDDDDWEEWDDDDDDWDDDDDDDWDDDW
WDEEEEEDWDDDWDDDWEEWDDDDDDDWDDDDDRWDDDRW
WWWWWWWWWDDDDWDWEEWDDDDDRDDWDDDDDWDDDDDW
WDD*DDDDDDDDDDWEEWDRDDDDDDDWDDWDWDDRDDDW
WDDDDDDDDDRDDWEEWDDDDDDDDDDWDDDMDDDDDDPW
WDDDDDDDDDDDWEEWWDDDDDRDDDDDDDWDWDDDDDDW
WRDDDDDDDDDWEEWDDWDDDDDD*DDDDWDDDW*DDDDW
WDDDDDDDDDWEEWDDRDWDDDDDDDDDWDDDDDWDDDDW
WDDDDRDDDDWEWDDDDDDWDDDDDDDDDDDDDDDWDDRW
WDDDDDDD*DWEWDDDDD*DWDDDDDDDDDDDRDDDWDDW
WDDDDDDDDDWEWD*DDDDDDWDDDDDDDDDDDDDDDWDW
WDDDDDDDDDWEWDDDDDDDDDWDDDDDDDDDDDDDDDWW
WDDRDDDDDDWEWDRDDDDDDDDWDDDDDDDDDDDDD*DW
WDDDDD*DDDWMWDDDDDRDDDDDWDRDDDD*DDDDRDDW
WZDDDDDDDDDEWDDDDDDDDD*DDWDDDDDDDDDDDDDW
WWWWWWWWWWWWWWWWWWWWWWWWWWWWWWWWWWWWWWWW