BIG cave
22 80
1 2
50
200 5000
-
WWWWWWWWWWWWWWWWWWWWWWWWWWWWWWWWWWWWWWWWWWWWWWWWWWWWWWWWWWWWWWWWWWWWWWWWWWWWWWWW
WZPDEDDDDDDERRDRDDDDWDREDDRDDEDDWRDDRDDDDDDDEDDDDDDERRDRDDDDDDREDDRDDEDDDRDDRDGW
WDDDDDRRDDDDDDEERDRDWDRDDDRDDDDDWRDDDDDDDDDDDDRRDDDDDDEERDRDDDRDDDRDDDDDDRDDDDDW
WDDDRDDD***DDDDDDDDDW***********WDDDEDEDDDDDRDDD***DDDDDDDDDDDDDDDDDDDDDDDDDEDEW
WDDDDDDRDDDDDDDDDDDDDRRRRRRRRRRRWWDDDDDDDDDDDDDRDDDDDDDDDDDDDSEEEEEEEEEEDWDDDDDW
WRRDDDDDDDDDDDDDDDDDDDDDDDDDDDDDDDDDDDDDDRRDDDDDDDDDDRERRRDDDSEEEEEEEEEEDRDDDDDW
WDDDDRDDREDDDDDDDDRRDDDDRDDDDDDDWDRRDDDDDDDDDRDDDDDDDDDDDDDDDDDDDDDDDDDDDDDRDDDW
WDED*DDRDDDDDDDDDDDDDDDDDEDDDDDDDDDDRDDDDDED*DDRDDDDDDDDDDDDDDDDDDDDDDDDDDDDRDDW
WDDDDEDDDDDDDDDDDDDDDDRDDRDDRDDDRDDDDRDDDDDDDEDDDDDDDDDDDDDDDDDDDDDDDDDDDDDDDRDW
WDDDDRDDDDEDDDDDDDDDRDDDDDRDDDRDDDDRRDRDDDDDDRDDDDDDDDDDDDDDDDDDDDDDDDDDDDDRRDRW
WDDDDDEDDDDDDDDDDDDDDRDDDDDDDDDDDDDDDDDDDDDDDDDRDDDDDDDDDDDDDDDDDDDDDDDDDDDDEDDW
WDDDDEDDDDDDDDDRDDERDDDDDDEDDDRDDDDDDDDDDRDDERDDDDRDEDDDRDDDDDDDDDDEDDDDDDDDDDDW
WGDDDDDDDDDDDDDEDDDDEDDRDDEDRDDD*DDDDDDDDEDDDDEDDRDDEDRDDDDDDDDDDDDDDDDD*DDDDDDW
WDRRDDDDDDDDRDDDDDDDDDDDDDMDDDDDRDDDDDRDDDDDDDDDDDDDMDDDDRDDDDDDRRDDDDDDRDDRDDDW
WDRDDDDDDDDDDDDDDDDDDDDDDDDDDDDD*DDDRDDDRRDDDRDDDDDDDDEDDDDDDDDDRDDDDRRD*DDDDDDW
WDDDDEDDDDDDDDDDDDDDDDDDDDDDDDDDDDDDERDDDEDRRDDDDDDDDDRRDDDDRDDDDDDEDDDDDDDDDDRW
WDDDRDDDDDDDDDDDDDDDDDDDDDDDDDDDDDEDDDDDDDDDDDDDRDDDDRDDDDDDDDDDDDRDRDDDDDEDDDDW
WDDDDDDDDDDDRRRDEDDDDDDDRDDDDDRDDDDDDDRRRDEDDDDDDDRDDDDDRDDDRDDDDDDDDDDDDDDDDDRW
WDDDDDDDDDRDDDDDDRDDDDERDDDDDDRDRDDDRDDDDDDRDDDDERDDDDDDRDDDDDDDDDDDDDDDRDDDDDDW
WDDRDD*DDDDDDDDRDSEEEEEEEEEDRDDRDDDDDDDDDRDDDDDDDDDDRDRDDDRDEDDDDRDD*DDRDDDDRDEW
WGDDDDDDEDDDDDDDDEEEEEEEEEEDDRRRDDDDDDDDDDDDDDDDDDDDDDDRRDDDDDDDDDDDDDERDDDDDDGW
WWWWWWWWWWWWWWWWWWWWWWWWWWWWWWWWWWWWWWWWWWWWWWWWWWWWWWWWWWWWWWWWWWWWWWWWWWWWWWWW