Treasure
23 41
11 20
2
1000 250
-
WWWWWWWWWWWWWWWWWWWWWWWWWWWWWWWWWWWWWWWWW
WRW********WEEEEEREEEEEREEEEEW********WRW
WRRW******WEEEEEEWDEEEDWEEEEEEW******WRRW
WRRRWWWWWWEEEEEERWDEEEDWREEEEEEWWWWWWRRRW
WDDDDDEEEEEEEEERWEDEEEDEWREEEEEEEEEDDDDDW
WEEEEWEEEEEEEERWEEDEEEDEEWREEEEEEEEWEEEEW
WEEEEEWEEEEEERWEEEDEEEDEEEWREEEEEEWEEEEEW
WEEEEEEWEEEERWEEEEDEEEDEEEEWREEEEWEEEEEEW
WEEEEEEEWEERWEEEEEDEEEDEEEEEWREEWEEEEEEEW
WMMMMMMMWWSWEEEEEEDEEEDEEEEEEWSWWMMMMMMMW
WDDDDDDDDDDDDDDDDDGEEEGDDDDDDDDDDDDDDDDDW
WZEEEEEEEEEEEEEEEEEEPEEEEEEEEEEEEEEEEEEZW
WDDDDDDDDDDDDDDDDDGEEEGDDDDDDDDDDDDDDDDDW
WEEEEEEDDDDDEEEEEEDEEEDEEEEEEDDDDDEEEEEEW
WEEEEEEDE*EDEEEEEEDEEEDEEEEEEDE*EDEEEEEEW
WEEEEEEDEWEDEEEEEEDEEEDEEEEEEDEWEDEEEEEEW
WEEEEEEDEEEDEEEEEEDEEEDEEEEEEDEEEDEEEEEEW
WEEEEEEDEEEDEEEEEEDEEEDEEEEEEDEEEDEEEEEEW
WEEEEEEDEEEDEEEEEEDEEEDEEEEEEDEEEDEEEEEEW
WEEEEEEDEEEDDDEEDDDEEEDDDEEDDDEEEDEEEEEEW
WEEEEEEDEEEEEEEEEEEEEEEEEEEEEEEEEDEEEEEEW
WEEEEEEDDDDDDDDDDDDEEEDDDDDDDDDDDDEEEEEEW
WWWWWWWWWWWWWWWWWWWWWWWWWWWWWWWWWWWWWWWWW